MMMMGTTTTTTTTTTTT
BTTTTTTTTTTTTTTTT
TTTTTTTTTTTTTTTTT
TTTTTTTTTTTTTTTTT
TTTTTTTTTTTTTTTBT
TTTTTTTTTTTMMMMGT