MGTAMGTTTTTGMMMTTTTTTTTTTTTTTTTTTTTTTTTTTTTTTTTTTT
TTTTTTTTTTTTTTTTTTTTTTTTTTTTTTTTTTTTTTTTTTTTTTTTTT
TTTMTTTTGGTTTTTTTTTTTBTTTTTTTTTTTTTAAAAAAAAAAATTTT
TTTTTTTTGGTTTTTTTTTTTTTTTTTTTTTAAAAAAAAAAAAAAAATTT
TTTTTTTTTTTTTTTTTTTTTTTTTTTTTTAAAAAAAAAAAAAAAATTTT
TTMMTTTGTTTTTTTTTTTTTTTTTTTTTTAAAAAAAAAAAAAAAATTTT
TTMTTTTTTTTTTTTTTTTTTTTTTTTTTAAAAAAAAAAAAAAAATTTTT
TTTTTTTTTTTTTTTTTTTTTTTTTTBTTTAAAAAAAAAAAAAAAATTTT
TTTTTTTTTTTTTTTTTTTTTTTTTTTTTTAAAAAAAAAAAAAAATTTTT
TTTTTBTTTTTTTTTTTTTTTTTTTTTTTTTTAAAAAAAAAAAAAAAATT
TTTTTTTTTTTTTTTTTTTTTTTTTTTTTTTTTTAAAAAAAAAAAAAAAA
TTTTTTTTTTTTTTTTTTTTTTTTTTTTTTTTTTTTAAAAAAAAAAAAAA
TTTTTTTTTTTTTTTTTTTTTTTTTTTTTTTTTTTTTTTAAAAAAAAAAA
TTTTTTTTTTTGGTTTTTTTTTTTTTTTTTMMMTTTTTTTTTTTTTAAAA
TTTTTTTTTTTTTTTTMTTTTTTTTTTTTTTTTTTTTTTGTTTGGGTAAA
TTGGTTTTTTTTTTTTTTTTTTTTTTTTTTTTTTBTTTTTTTTTTTTTAA
TTTTTTTTTMTTTTTTTTTTTTTTTTTTTTTTTTTTTTTTTTTTTTTTAA
TTTTTTTTTTTTTTTTTTTTTTTTTTTTTTTTTTTTTTTTTTTTTTTAAA
TTTTTTTTTTTTTTTTTTTTTTTTTTTTTTTTTTTTTTTTTTTTTAAAAA
TTTTTTTTTTTTTTTTTTTTTTTTTTTTTTTTTTTTTTTTTTTAAAAAAA
TTTTTTTTTTTTTTTTTTTTTTTTTTTTTTTTTTTTTTTTTTAAAAAAAA
TTTTTTTTTTTTTTTTTTTTTTTTTTTTTTTTTTTTTTTTTTTAAAAAAA
TTTTTTTTTTTTTTTTTTTTTTTTTTTTTTTTTTTTTTTTTTAAAAAAAA
TTTTTTTTTTTTTTTTTTTTTTTTTTTTTTTTTTTTTTTTTTTAAAAAAA
TTTTTTTTTTTTTTTTTTTTTTTTTTTTTTTTTTTTTTTTTTAAAAAAAA
TTTTTTTTTTTTTTTTTTTTTTTTTTTTTTTTTTTTTTTTTAAAAAAAAA
TTTTTTTTTTTTMTTTTTTTTTTTTTTTTTTTMTTTBTTTAAAAAAAAAA
TTTTTTTTTTTTTMTBTTGTTTTTTTTTTTTTTGTTTTTAAAAAAAAAAA
TTTTTTTTTTTTGTTTTTTTTTTTTTTTTTGTTTTTMTTAAAAAAAAAAA
AAAAAAAAAAAAAAAAAAAAAAAAAAAAAAAAAAAAAAAAAAAAAAAAAA
AAAAAAAAAAAAAAAAAAAAAAAAAAAAAAAAAAAAAAAAAAAAAAAAAA
AAAAAAAAAAAAAAAAAAAAAAAAAAAAAAAAAAAAAAAAAAAAAAAAAA
AAAAAAAAAAAAAAAAAAAAAAAAAAAAAAAAAAAAAAAAAAAAAAAAAA
AAAAAAAAAAAAAAAAAAAAAAAAAAAAAAAAAAAAAAAAAAAAAAAAAA
AAAAAAAAAAAAAAAAAAAAAAAAAAAAAAAAAAAAAAAAAAAAAAAAAA
AAAAAAAAAAAAAAAAAAAAAAAAAAAAAAAAAAAAAAAAAAAAAAAAAA