MGTAMGTTTTTGMMMTTTTTTTTTTTTTTTTTTTTTTTTTTTTTTTTTTT
TTTTTTTTTTTTTTTTTTTTTTTTTTTTTTTTTTTAAAAAAAAAAAATTT
TTTMTTTTGGTTTTTTTTTTTTTTTTTTTTTAAAAAAAAAAAAAAATTTT
TTTTTTTTGGTTTTTTTTTTTTTTTTTTTTTAAAAAAAAAAAAAAAATTT
TTTTTTTTTTTTTTTTTTTTTTTTTTTTTTAAAAAAAAAAAAAAAATTTT
TTMMTTTGTTTTTTTTTTTTTTTTTTTTTTAAAAAAAAAAAAAAAATTTT
TTMTTTTTTTTTTTTTTTTTTTTTTTTTTAAAAAAAAAAAAAAAATTTTT
TTTTTTTTTTTTTTTTTTTTTTTTTTTTTTAAAAAAAAAAAAAAAATTTT
TTTTTTTTTTTTTTTTTTTTTTTTTTTTTTAAAAAAAAAAAAAAATTTTT
TTTTTTTTTTTTTTTTTTTTTTTTTTTTTTTTAAAAAAAAAAAAAAAATT
TTTTTTTTTTTTTTTTTTTTTTTTTTTTTTTTTTAAAAAAAAAAAAAAAA
TTTTTTTTTTTTTTTTTTTTTTTTTTTTTTTTTTTTAAAAAAAAAAAAAA
TTTTTTTTTTTTTTTTTTTTTTTTTTTTTTTTTTTTTTTAAAAAAAAAAA
TTTTTTTTTTTGGTTTTTTTTTTTTTTTTTMMMTTTTTTTTTTTTTTTTT
TTTTTTTTTTTTTTTTMTTTTTTTTTTTTTTTTTTTTTTGTTTGGGTTTT
TTGGTTTTTTTTTTTTTTTTTTTTTTTTTTTTTTTTTTTTTTTTTTTTTT
TTTTTTTTTMTTTTTTTTTTTTTTTTTTTTTTTTTTTTTTTTTTTTTTTT
