MGTAMGTTTTTGMMMTTTTTTTTTTTTTTTTTTTTTTTTTTTTTTTTTTT
TTTTTTTTTTTTTTTTTTTTTTTTTTTTTTTTTTTTTTTTTTTTTTTTTT
TTTMTTTTGGTTTTTTTTTTTTTTTTTTTTTTTTTAAAAAAAAAAATTTT
TTTTTTTTGGTTTTTTTTTTTTTTTTTTTTTAAAAAAAAAAAAAAAATTT
TTTTTTTTTTTTTTTTTTTTTTTTTTTTTTAAAAAAAAAAAAAAAATTTT
TTMMTTTGTTTTTTTTTTTTTTTTTTTTTTAAAAAAAAAAAAAAAATTTT
TTMTTTTTTTTTTTTTTTTTTTTTTTTTTAAAAAAAAAAAAAAAATTTTT
TTTTTTTTTTTTTTTTTTTTTTTTTTTTTTAAAAAAAAAAAAAAAATTTT
TTTTTTTTTTTTTTTTTTTTTTTTTTTTTTAAAAAAAAAAAAAAATTTTT
TTTTTTTTTTTTTTTTTTTTTTTTTTTTTTTTAAAAAAAAAAAAAAAATT
TTTTTTTTTTTTTTTTTTTTTTTTTTTTTTTTTTAAAAAAAAAAAAAAAA
TTTTTTTTTTTTTTTTTTTTTTTTTTTTTTTTTTTTAAAAAAAAAAAAAA
TTTTTTTTTTTTTTTTTTTTTTTTTTTTTTTTTTTTTTTAAAAAAAAAAA
TTTTTTTTTTTGGTTTTTTTTTTTTTTTTTMMMTTTTTTTTTTTTTAAAA
TTTTTTTTTTTTTTTTMTTTTTTTTTTTTTTTTTTTTTTGTTTGGGTAAA
TTGGTTTTTTTTTTTTTTTTTTTTTTTTTTTTTTTTTTTTTTTTTTTTAA
TTTTTTTTTMTTTTTTTTTTTTTTTTTTTTTTTTTTTTTTTTTTTTTTAA
TTTTTTTTTTTTTTTTTTTTTTTTTTTTTTTTTTTTTTTTTTTTTTTAAA
TTTTTTTTTTTTTTTTTTTTTTTTTTTTTTTTTTTTTTTTTTTTTAAAAA
TTTTTTTTTTTTTTTTTTTTTTTTTTTTTTTTTTTTTTTTTTTAAAAAAA
TTTTTTTTTTTTTTTTTTTTTTTTTTTTTTTTTTTTTTTTTTAAAAAAAA
TTTTTTTTTTTTTTTTTTTTTTTTTTTTTTTTTTTTTTTTTAAAAAAAAA
TTTTTTTTTTTTTTTTTTTTTTTTTTTTTTTTTTTTTTTTAAAAAAAAAA
TTTTTTTTTTTTTTTTTTTTTTTTTTTTTTTTTTTTTTTAAAAAAAAAAA
TTTTTTTTTTTTTTTTTTTTTTTTTTTTTTTTTTTTTTTAAAAAAAAAAA
AAAAAAAAAAAAAAAAAAAAAAAAAAAAAAAAAAAAAAAAAAAAAAAAAA
AAAAAAAAAAAAAAAAAAAAAAAAAAAAAAAAAAAAAAAAAAAAAAAAAA
AAAAAAAAAAAAAAAAAAAAAAAAAAAAAAAAAAAAAAAAAAAAAAAAAA
AAAAAAAAAAAAAAAAAAAAAAAAAAAAAAAAAAAAAAAAAAAAAAAAAA
AAAAAAAAAAAAAAAAAAAAAAAAAAAAAAAAAAAAAAAAAAAAAAAAAA
AAAAAAAAAAAAAAAAAAAAAAAAAAAAAAAAAAAAAAAAAAAAAAAAAA
AAAAAAAAAAAAAAAAAAAAAAAAAAAAAAAAAAAAAAAAAAAAAAAAAA